111111111111111111
10101100C00000C001
100000000000000001
100000000C00000001
100E0000000000C001
100000P00000000001
111111111111111111